16,13,13,13,13,13,13,13,13,13,13,13,13,13,13,13,13,13,13,17
16,15,15,15,15,15,15,15,15,15,15,15,15,15,15,15,15,15,15,17
16,0,0,0,0,0,0,0,0,0,0,0,0,0,0,0,0,0,0,17
16,0,0,0,0,0,0,0,0,0,0,0,0,0,0,0,0,0,0,17
16,0,0,0,0,0,0,0,0,0,0,0,0,0,0,0,0,0,0,17
16,1,0,0,0,0,0,0,0,0,0,0,0,0,0,0,0,0,0,17
16,1,1,0,0,0,0,0,2,0,0,0,1,0,0,0,0,0,0,17
1,1,1,1,1,1,1,1,1,1,1,1,1,1,1,1,1,1,1,1
1,1,1,1,1,1,1,1,1,1,1,1,1,1,1,1,1,1,1,1
